$ layers
2
Floor.png
$ rows. Cols are calculated automatically
24
156, 156, 156, 156, 156, 156, 156, 156,		156, 156, 156, 156, 156, 156, 156, 156, 	156, 156, 156, 156, 156, 156, 156, 156, 	156, 156, 156, 156, 156, 156, 156, 156,
156, 156, 156, 156, 156, 156, 156, 156, 	156, 156, 156, 156, 156, 156, 156, 156, 	156, 156, 156, 156, 156, 156, 156, 156, 	156, 156, 156, 156, 156, 156, 156, 156,
156, 156, 156, 156, 156, 156, 156, 156, 	156, 156, 156, 156, 156, 156, 156, 156, 	156, 156, 156, 156, 156, 156, 156, 156, 	156, 156, 156, 156, 156, 156, 156, 156,
156, 156, 156, 156, 156, 156, 156, 156, 	156, 156, 156, 156, 156, 156, 156, 156, 	156, 156, 156, 156, 156, 156, 156, 156,		156, 156, 156, 156, 156, 156, 156, 156, 
156, 156, 156, 156, 156, 156, 156, 156, 	156, 156, 156, 156, 156, 156, 156, 156, 	156, 156, 156, 156, 156, 156, 156, 156, 	156, 156, 156, 156, 156, 156, 156, 156,
156, 156, 156, 156, 156, 156, 156, 156, 	156, 156, 156, 156, 156, 156, 156, 156, 	156, 156, 156, 156, 156, 156, 156, 156, 	156, 156, 156, 156, 156, 156, 156, 156,
156, 156, 156, 156, 156, 156, 156, 156, 	156, 156, 156, 156, 156, 156, 156, 156, 	156, 156, 156, 156, 156, 156, 156, 156, 	156, 156, 156, 156, 156, 156, 156, 156,
156, 156, 156, 156, 156, 156, 156, 156, 	156, 156, 156, 156, 156, 156, 156, 156, 	156, 156, 156, 156, 156, 156, 156, 156, 	156, 156, 156, 156, 156, 156, 156, 156,
$
156, 156, 156, 156, 156, 156, 156, 156,		156, 156, 156, 156, 156, 156, 156, 156, 	156, 156, 156, 156, 156, 156, 156, 156, 	156, 156, 156, 156, 156, 156, 156, 156,
156, 156, 156, 156, 156, 156, 156, 156, 	156, 156, 156, 156, 156, 156, 156, 156, 	156, 156, 156, 156, 156, 156, 156, 156, 	156, 156, 156, 156, 156, 156, 156, 156,
156, 156, 156, 156, 156, 156, 156, 156, 	156, 156, 156, 156, 156, 156, 156, 156, 	156, 156, 156, 156, 156, 156, 156, 156, 	156, 156, 156, 156, 156, 156, 156, 156,
156, 156, 156, 156, 156, 156, 156, 156, 	156, 156, 156, 156, 156, 156, 156, 156, 	156, 156, 156, 156, 156, 156, 156, 156,		156, 156, 156, 156, 156, 156, 156, 156, 
156, 156, 156, 156, 156, 156, 156, 156, 	156, 156, 156, 156, 156, 156, 156, 156, 	156, 156, 156, 156, 156, 156, 156, 156, 	156, 156, 156, 156, 156, 156, 156, 156,
156, 156, 156, 156, 156, 156, 156, 156, 	156, 156, 156, 156, 156, 156, 156, 156, 	156, 156, 156, 156, 156, 156, 156, 156, 	156, 156, 156, 156, 156, 156, 156, 156,
156, 156, 156, 156, 156, 156, 156, 156, 	156, 156, 156, 156, 156, 156, 156, 156, 	156, 156, 156, 156, 156, 156, 156, 156, 	156, 156, 156, 156, 156, 156, 156, 156,
156, 156, 156, 156, 156, 156, 156, 156, 	156, 156, 156, 156, 156, 156, 156, 156, 	156, 156, 156, 156, 156, 156, 156, 156, 	156, 156, 156, 156, 156, 156, 156, 156,
$
156, 156, 156, 156, 156, 156, 156, 156,		156, 156, 156, 156, 156, 156, 156, 156, 	156, 156, 156, 156, 156, 156, 156, 156, 	156, 156, 156, 156, 156, 156, 156, 156,
156, 156, 156, 156, 156, 156, 156, 156, 	156, 156, 156, 156, 156, 156, 156, 156, 	156, 156, 156, 156, 156, 156, 156, 156, 	156, 156, 156, 156, 156, 156, 156, 156,
156, 156, 156, 156, 156, 156, 156, 156, 	156, 156, 156, 156, 156, 156, 156, 156, 	156, 156, 156, 156, 156, 156, 156, 156, 	156, 156, 156, 156, 156, 156, 156, 156,
156, 156, 156, 156, 156, 156, 156, 156, 	156, 156, 156, 156, 156, 156, 156, 156, 	156, 156, 156, 156, 156, 156, 156, 156,		156, 156, 156, 156, 156, 156, 156, 156, 
156, 156, 156, 156, 156, 156, 156, 156, 	156, 156, 156, 156, 156, 156, 156, 156, 	156, 156, 156, 156, 156, 156, 156, 156, 	156, 156, 156, 156, 156, 156, 156, 156,
156, 156, 156, 156, 156, 156, 156, 156, 	156, 156, 156, 156, 156, 156, 156, 156, 	156, 156, 156, 156, 156, 156, 156, 156, 	156, 156, 156, 156, 156, 156, 156, 156,
156, 156, 156, 156, 156, 156, 156, 156, 	156, 156, 156, 156, 156, 156, 156, 156, 	156, 156, 156, 156, 156, 156, 156, 156, 	156, 156, 156, 156, 156, 156, 156, 156,
156, 156, 156, 156, 156, 156, 156, 156, 	156, 156, 156, 156, 156, 156, 156, 156, 	156, 156, 156, 156, 156, 156, 156, 156, 	156, 156, 156, 156, 156, 156, 156, 156,	
$
Wall.png
$ dimensions
24, 32
$
7, 7, 7, 7, 7, 7, 7, 7,		7, 7, 7, 7, 7, 7, 7, 7,		7, 7, 7, 7, 7, 7, 7, 7,		7, 7, 7, 7, 7, 7, 7, 7,
7, 7, 7, 7, 7, 7, 7, 7,		7, 7, 7, 7, 7, 7, 7, 7,		7, 7, 7, 7, 7, 7, 7, 7,		7, 7, 7, 7, 7, 7, 7, 7,
7, 7, 7, 7, 7, 7, 7, 7,		7, 7, 7, 7, 7, 7, 7, 7,		7, 7, 7, 7, 7, 7, 7, 7,		7, 7, 7, 7, 7, 7, 7, 7,
7, 7, 7, 7, 7, 7, 7, 7,		7, 7, 7, 7, 7, 7, 7, 7,		7, 7, 7, 7, 7, 7, 7, 7,		7, 7, 7, 7, 7, 7, 7, 7,
7, 7, 7, 7, 7, 7, 7, 7,		7, 7, 7, 7, 7, 7, 7, 7,		7, 7, 7, 7, 7, 7, 7, 7,		7, 7, 7, 7, 7, 7, 7, 7,
7, 7, 7, 7, 7, 7, 7, 7,		7, 7, 7, 7, 7, 7, 7, 7,		7, 7, 7, 7, 7, 7, 7, 7,		7, 7, 7, 7, 7, 7, 7, 7,
7, 7, 7, 7, 7, 7, 7, 7,		7, 7, 7, 7, 7, 7, 7, 7,		7, 7, 7, 7, 7, 7, 7, 7,		7, 7, 7, 7, 7, 7, 7, 7,
7, 7, 7, 7, 7, 7, 7, 7,		7, 7, 7, 7, 7, 7, 7, 7,		7, 7, 7, 7, 7, 7, 7, 7,		7, 7, 7, 7, 7, 7, 7, 7,
$
7, 7, 7, 7, 7, 7, 7, 7,		7, 7, 7, 7, 7, 7, 7, 7,		7, 7, 7, 7, 7, 7, 7, 7,		7, 7, 7, 7, 7, 7, 7, 7,
7, 7, 7, 7, 7, 7, 7, 7,		7, 71,71, 72, 7, 7, 7, 7,		7, 7, 7, 7, 7, 7, 7, 7,		7, 7, 7, 7, 7, 7, 7, 7,
7, 7, 7, 7, 7, 7, 7, 7,		7, 7, 7, 7, 7, 7, 7, 7,		7, 7, 7, 7, 7, 7, 7, 7,		7, 7, 7, 7, 7, 7, 7, 7,
7, 7, 7, 7, 7, 7, 7, 7,		7, 7, 7, 7, 7, 7, 7, 7,		7, 7, 7, 7, 7, 7, 7, 7,		7, 7, 7, 7, 7, 7, 7, 7,
7, 7, 7, 7, 7, 7, 7, 7,		7, 7, 7, 7, 7, 7, 7, 7,		7, 7, 7, 7, 7, 7, 7, 7,		7, 7, 7, 7, 7, 7, 7, 7,
7, 7, 7, 7, 7, 7, 7, 7,		7, 7, 7, 7, 7, 7, 7, 7,		7, 7, 7, 7, 7, 7, 7, 7,		7, 7, 7, 7, 7, 7, 7, 7,
7, 7, 7, 7, 7, 7, 7, 7,		7, 7, 7, 7, 7, 7, 7, 7,		7, 7, 7, 7, 7, 7, 7, 7,		7, 7, 7, 7, 7, 7, 7, 7,
7, 7, 7, 7, 7, 7, 7, 7,		7, 7, 7, 7, 7, 7, 7, 7,		7, 7, 7, 7, 7, 7, 7, 7,		7, 7, 7, 7, 7, 7, 7, 7,
$
7, 7, 7, 7, 7, 7, 7, 7,		7, 7, 7, 7, 7, 7, 7, 7,		7, 7, 7, 7, 7, 7, 7, 7,		7, 7, 7, 7, 7, 7, 7, 7,
7, 7, 7, 7, 7, 7, 7, 7,		7, 7, 7, 7, 7, 7, 7, 7,		7, 7, 7, 7, 7, 7, 7, 7,		7, 7, 7, 7, 7, 7, 7, 7,
7, 7, 7, 7, 7, 7, 7, 7,		7, 7, 7, 7, 7, 7, 7, 7,		7, 7, 7, 7, 7, 7, 7, 7,		7, 7, 7, 7, 7, 7, 7, 7,
7, 7, 7, 7, 7, 7, 7, 7,		7, 7, 7, 7, 7, 7, 7, 7,		7, 7, 7, 7, 7, 7, 7, 7,		7, 7, 7, 7, 7, 7, 7, 7,
7, 7, 7, 7, 7, 7, 7, 7,		7, 7, 7, 7, 7, 7, 7, 7,		7, 7, 7, 7, 7, 7, 7, 7,		7, 7, 7, 7, 7, 7, 7, 7,
7, 7, 7, 7, 7, 7, 7, 7,		7, 7, 7, 7, 7, 7, 7, 7,		7, 7, 7, 7, 7, 7, 7, 7,		7, 7, 7, 7, 7, 7, 7, 7,
7, 7, 7, 7, 7, 7, 7, 7,		7, 7, 7, 7, 7, 7, 7, 7,		7, 7, 7, 7, 7, 7, 7, 7,		7, 7, 7, 7, 7, 7, 7, 7,
7, 7, 7, 7, 7, 7, 7, 7,		7, 7, 7, 7, 7, 7, 7, 7,		7, 7, 7, 7, 7, 7, 7, 7,		7, 7, 7, 7, 7, 7, 7, 7,
$wall logic grid
0,0,0,0,0,0,0,0		0,0,0,0,0,0,0,0		0,0,0,0,0,0,0,0		0,0,0,0,0,0,0,0
0,0,0,0,0,0,0,0		0,0,0,0,0,0,0,0		0,0,0,0,0,0,0,0		0,0,0,0,0,0,0,0
0,0,0,0,0,0,0,0		0,0,0,0,0,0,0,0		0,0,0,0,0,0,0,0		0,0,0,0,0,0,0,0
0,0,0,0,0,0,0,0		0,0,0,0,0,0,0,0		0,0,0,0,0,0,0,0		0,0,0,0,0,0,0,0
0,0,0,0,0,0,0,0		0,0,0,0,0,0,0,0		0,0,0,0,0,0,0,0		0,0,0,0,0,0,0,0
0,0,0,0,0,0,0,0		0,0,0,0,0,0,0,0		0,0,0,0,0,0,0,0		0,0,0,0,0,0,0,0
0,0,0,0,0,0,0,0		0,0,0,0,0,0,0,0		0,0,0,0,0,0,0,0		0,0,0,0,0,0,0,0
0,0,0,0,0,0,0,0		0,0,0,0,0,0,0,0		0,0,0,0,0,0,0,0		0,0,0,0,0,0,0,0
$
0,0,0,0,0,0,0,0		0,0,0,0,0,0,0,0		0,0,0,0,0,0,0,0		0,0,0,0,0,0,0,0
0,0,0,0,0,0,0,0		0,1,1,1,0,0,0,0		0,0,0,0,0,0,0,0		0,0,0,0,0,0,0,0
0,0,0,0,0,0,0,0		0,0,0,0,0,0,0,0		0,0,0,0,0,0,0,0		0,0,0,0,0,0,0,0
0,0,0,0,0,0,0,0		0,0,0,0,0,0,0,0		0,0,0,0,0,0,0,0		0,0,0,0,0,0,0,0
0,0,0,0,0,0,0,0		0,0,0,0,0,0,0,0		0,0,0,0,0,0,0,0		0,0,0,0,0,0,0,0
0,0,0,0,0,0,0,0		0,0,0,0,0,0,0,0		0,0,0,0,0,0,0,0		0,0,0,0,0,0,0,0
0,0,0,0,0,0,0,0		0,0,0,0,0,0,0,0		0,0,0,0,0,0,0,0		0,0,0,0,0,0,0,0
0,0,0,0,0,0,0,0		0,0,0,0,0,0,0,0		0,0,0,0,0,0,0,0		0,0,0,0,0,0,0,0
$
0,0,0,0,0,0,0,0		0,0,0,0,0,0,0,0		0,0,0,0,0,0,0,0		0,0,0,0,0,0,0,0
0,0,0,0,0,0,0,0		0,0,0,0,0,0,0,0		0,0,0,0,0,0,0,0		0,0,0,0,0,0,0,0
0,0,0,0,0,0,0,0		0,0,0,0,0,0,0,0		0,0,0,0,0,0,0,0		0,0,0,0,0,0,0,0
0,0,0,0,0,0,0,0		0,0,0,0,0,0,0,0		0,0,0,0,0,0,0,0		0,0,0,0,0,0,0,0
0,0,0,0,0,0,0,0		0,0,0,0,0,0,0,0		0,0,0,0,0,0,0,0		0,0,0,0,0,0,0,0
0,0,0,0,0,0,0,0		0,0,0,0,0,0,0,0		0,0,0,0,0,0,0,0		0,0,0,0,0,0,0,0
0,0,0,0,0,0,0,0		0,0,0,0,0,0,0,0		0,0,0,0,0,0,0,0		0,0,0,0,0,0,0,0
0,0,0,0,0,0,0,0		0,0,0,0,0,0,0,0		0,0,0,0,0,0,0,0		0,0,0,0,0,0,0,0
$

























